                              
##############################
#                            #
#                            #
#                            #
#                            #
#=======                     #
#                            #
#                 ===========#
#                            #
#                            #
# ======                     #
#             =========      #
#                            #
#                            #
#                            #
#                            #
#                  ==========#
#                            #
#                            #
#                            #
#                            #
#=============               #
#                            #
#                            #
#                            #
#                            #
#                            #
#                            #
##############################
