                              
##############################
#                            #
#                            #
#                            #
#                            #
#                            #
#                            #
#                            #
#                            #
#                            #
#                            #
#                            #
#                            #
#==  ====================  ==#
#                            #
#                            #
#                            #
#                            #
#==  ====================  ==#
#                            #
#                            #
#                            #
#                            #
#==  ====================  ==#
#                            #
#                            #
#                            #
#                            #
##############################
