                              
##############################
#                            #
#                            #
#                            #
#                            #
#                            #
#                            #
#                            #
#            ====            #
#                            #
#                            #
#                            #
#                            #
#                            #
#         ====  ====         #
#                            #
#                            #
#                            #
#                            #
#      ================      #
#                            #
#                            #
#                            #
#                            #
#  ======  =======  =======  #
#                            #
#                            #
#                            #
##############################
