                              
##############################
#                            #
#                            #
#                            #
#                            #
#                         ===#
#                            #
#                  =====     #
#                            #
#                            #
#                            #
#=========        ======     #
#                            #
#                            #
#                            #
#                            #
#=====              =========#
#                            #
#                            #
#                            #
#                            #
#============                #
#                            #
#                            #
#               ========     #
#                            #
#                            #
#                            #
##############################
