                              
##############################
#                            #
#                            #
#                            #
#                            #
=======       ===            #
#                            #
#                            #
#                    ========#
#                            #
#                            #
#=========                   #
#                            #
#                            #
#                            #
#                            #
#=====        ==========     #
#                            #
#                            #
#                            #
#                            #
#                   =========#
#                            #
#                            #
#    =======                 #
#                            #
#                            #
#                            #
##############################
