                              
########   ########   ########
#      #              #      #
#      #==          ==#      #
#                            #
#                            #
#                            #
#    #======##  ##======#    #
#    #      ##  ##      #    #
#    #      ##  ##      #    #
#    #      ##  ##      #    #
#    #==    ##  ##    ==#    #
#           ##  ##           #
#           ##  ##           #
#           ##  ##           #
#           ##  ##           #
#           ##  ##           #
#   #===              ===#   #
#   #                    #   #
#   #                    #   #
#   #                    #   #
#   #                    #   #
#   #                    #   #
#   #======        ======#   #
#                            #
#                            #
#                            #
#                            #
#                            #
########   ########   ########
