                              
########   ########   ########
#                            #
#                            #
#                            #
#  #                    #    #
#  # ===================#    #
#                            #
#                            #
#                            #
#                            #
#  #                    #    #
#  #=================== #    #
#                            #
#                            #
#                            #
#                            #
#  #                    #    #
#  # ===================#    #
#                            #
#                            #
#                            #
#                            #
#  #                    #    #
#  # ========  =========#    #
#                            #
#                            #
#                            #
#                            #
########   ########   ########
