                              
########   ########   ########
#                            #
#                            #
#                            #
#                            #
#   =========================#
#                            #
#                            #
#                            #
#                            #
#                            #
#========================    #
#                            #
#                            #
#                            #
#                            #
#                            #
#  ==========================#
#                            #
#                            #
#                            #
#                            #
#                            #
#========================    #
#                            #
#                            #
#                            #
#                            #
########   ########   ########
