                              
########   ########   ########
#                            #
#                            #
#                            #
#                            #
#======                ======#
#                            #
#                            #
#                            #
#                            #
#                            #
#========            ========#
#                            #
#                            #
#                            #
#                            #
#                            #
#==========        ==========#
#                            #
#                            #
#                            #
#                            #
#                            #
#  ==========    ==========  #
#                            #
#                            #
#                            #
#                            #
########   ########   ########
