                              
########   ########   ########
#                            #
#   #                    #   #
#   #                    #   #
#   #                    #   #
#   #  ===          ===  #   #
#   #                    #   #
#   #                    #   #
#   #                    #   #
#   #                    #   #
#   #  ==            ==  #   #
#   #                    #   #
#                            #
#                            #
#                            #
#                            #
#                            #
#      ================      #
#                            #
#                            #
#                            #
#                            #
#                            #
#====  ==  ========  ==  ====#
#                            #
#                            #
#                            #
#                            #
########   ########   ########
