                              
########   ########   ########
#                            #
#                            #
#                            #
#                            #
#   ====      ==      ====   #
#                            #
#                            #
#                            #
#                            #
#                            #
#  =====     =====    =====  #
#                            #
#                            #
#                            #
#                            #
#                            #
#   ====    =======   ====   #
#                            #
#                            #
#                            #
#    ====  ===  ===  ====    #
#                            #
#                            #
#     =======   =======      #
#                            #
#                            #
#                            #
########   ########   ########
